0GreenLizard|Green Lizard
PinkLizard|Pink Lizard
BlueLizard|Blue Lizard
WhiteLizard|White Lizard
BlackLizard|Black Lizard
YellowLizard|Yellow Lizard
CyanLizard|Cyan Lizard
RedLizard|Red Lizard
Fly|Batfly
CicadaA|White Cicada
CicadaB|Black Cicada
SeaLeech|Sea Leech
PoleMimic|Pole Mimic
TentaclePlant|Monster Kelp
VultureGrub|Vulture Grub
KingVulture|King Vulture
SmallCentipede|Small Centipede
MediumCentipede|Medium Centipede
BigCentipede|Big Centipede
RedCentipede|Red Centipede
TubeWorm|Grapple Worm
LanternMouse|Lantern Mouse
SlimeMold|Slime Mold
BubbleGrass|Bubble Grass
DangleFruit|Blue Fruit
FirecrackerPlant|Firecracker Plant
WaterNut|Bubble fruit
PuffBall|Spore Puff
FlareBomb|Flashbang
FlyLure|Batnip
SporePlant|Beehive
ScavengerBomb|Scavenger Bomb
FireSpear|Explosive Spear
BigEel|Leviathan
SmallNeedleWorm|Small Noodlefly
BigNeedleWorm|Big Noodlefly
DropBug|Dropwig
DaddyLongLegs|Daddy Long Legs
BrotherLongLegs|Brother Long Legs
MirosBird|Miros Bird
SpitterSpider|Spitter Spider
BigSpider|Big Spider
ZoopLizard|Strawberry Lizard
StowawayBug|Stowaway
JungleLeech|Jungle Leech
DandelionPeach|Dandelion Peach
BigJelly|Big Jellyfish
GlowWeed|Glow Weed
LillyPuck|Lillypuck
GooieDuck|Gooie Duck
ElectricSpear|Electric Spear
EnergyCell|Rarefaction Cell
ScavengerElite|Elite Scavenger
VultureMask|Vulture Mask
SlugNPC|Slugpup
JokeRifle|Gun
SingularityBomb|Singularity Bomb
HellSpear|Fire Spear
FireEgg|Fire Egg
FireBug|Firebug
AquaCenti|Aquapede
TerrorLongLegs|Terror Long Legs
MotherSpider|Mother Spider
EelLizard|Eel Lizard
SpitLizard|Caramel Lizard
MirosVulture| Miros Vulture
filter|Filtration System Arenas
gutter|Gutter Arenas
GWold|Past Garbage Wastes
LM|Waterfront Facility Arenas
VS|Pipeyard Arenas
CL|Silent Construct Arenas
RM|Rot Arenas
OE|Outer Expanse Arenas
DM|Looks to the Moon Arenas
HR|Rubicon Arenas
UG|Undergrowth Arenas
MS|Submerged Superstructure Arenas
LC|Metropolis Arenas
SS|Five Pebbles Arenas
SB|Subterranean Arenas
UW|Exterior Arenas
LF|Farm Arrays Arenas
SI|Sky Islands Arenas
SH|Shaded Citadel Arenas
SL|Shoreline Arenas
GW|Garbage Wastes Arenas
CC|Chimney Canopy Arenas
HI|Industrial Complex Arenas
SU|Outskirts Arenas
DS|Drainage System Arenas
WARA|Shattered Terrace Arenas
WARB|Salination Arenas
WARC|Fetid Glen Arenas
WARD|Cold Storage Arenas
WARE|Heat Ducts Arenas
WARF|Aether Ridge Arenas
WARG|The Surface Arenas
WSKA|Torrential Railways Arenas
WSKB|Sunbaked Alley Arenas
WSKC|Stormy Coast Arenas
WSKD|Shrouded Stacks Arenas
WRFA|Coral Caves Arenas
WRFB|Turbulent Pump Arenas
WTDA|Torrid Desert Arenas
WTDB|Desolate Tract Arenas
WVWA|Verdant Waterways Arenas
WVWB|Fractured Gateways Arenas
WBLA|Badlands Arenas
WMPA|Migration Path Arenas
WPGA|Pillar Grove Arenas
WRRA|Rusted Wrecks Arenas
WPTA|Signal Spires Arenas
WAUA|Ancient Urban Arenas
LM-safari|Waterfront Facility Safari
VS-safari|Pipeyard Safari
CL-safari|Silent Construct Safari
RM-safari|Rot Safari
OE-safari|Outer Expanse Safari
DM-safari|Looks to the Moon Safari
HR-safari|Rubicon Safari
UG-safari|Undergrowth Safari
MS-safari|Submerged Superstructure Safari
LC-safari|Metropolis Safari
SS-safari|Five Pebbles Safari
SB-safari|Subterranean Safari
UW-safari|Exterior Safari
LF-safari|Farm Arrays Safari
SI-safari|Sky Islands Safari
SH-safari|Shaded Citadel Safari
SL-safari|Shoreline Safari
GW-safari|Garbage Wastes Safari
CC-safari|Chimney Canopy Safari
HI-safari|Industrial Complex Safari
SU-safari|Outskirts Safari
DS-safari|Drainage System Safari